...###
..##.#.#.#
.##..###..
##........
#...@..#..
###..###..
..#..#....
.##.##.#.#
.#......##
.#.....##